############################
#..........................#
#####.####################.#
#........................#.#
########...##.############.#
#...#..#.###...........#.#.#
#..###.#.#..#########..#...#
#....................#.#####
#.####.#############.#.....#
#...#...............#......#
###################F########