#############################
#...........................#
######..##########...###.####
#......####........####..####
######..#####.####...###.##.#
#####..#####...#...#..##....#
#.....###....###.#...##..#.##
#.#####...##########....#####
#####...##########....#..####
#.....#..########..#####..###
####..##..#######........####
#########F###################
