###################################
#.................................#
##..######..#####..######.#####..##
#..#####...#######..####...###..###
##.....#.#.#####...###...#..###..##
####..##...####..#..#..#...###..###
#....########...###...####..#######
###...##...###..##...######.......#
#...#..##..####....#############.##
##..##....########......######...##
###....#####...#....###...#########
#...########.#.#.##...###...###...#
#.###....###.#...#########..###.#.#
#.....##.#######....##.####.###.#.#
########......#####.##.####.....#.#
#.##.....####.#####....##########.#
#.######.####...#########.........#
#........######.#.........#########
#################F#################
